p0p0p|p0p
0+-+0+0+0
p|p0p0p|p
0+0+-+-+0
p|p|E0p0p
0+-+-+0+-
p0p0p0p0S
