S0p0p0p|p0p
-+0+-+0+0+-
p0p0p|p0p|p
0+-+-+-+-+0
p|p0p0p0p0p
0+-+0+0+-+0
p|p0p|p|E|p
0+-+0+0+0+0
p|p0p|p0p|p
0+0+-+0+-+0
p0p|p0p0p0p



S0p0p0p|p0p0p0p
-+0+-+0+0+-+0+0
p0p0p|p0p|p|p|p
0+-+-+-+-+0+0+-
p|p0p0p0p0p|p0p
0+-+0+0+-+0+-+0
p|p0p|p|E|p0p0p
0+-+0+0+0+0+0+-
p|p0p|p0p|p|p0p
0+0+0+-+-+-+-+0
p0p|p0p0p|p0p0p
-+0+0+-+0+0+-+-
p0p|p|p0p|p0p0p
0+-+0+-+0+-+0+-
p0p0p0p|p0p0p0p
