E0p0p0p0p
000000000
p0p0p0p0p
000000000
p0p0S0p0p
000000000
p0p0p0p0p
000000000
p0p0p0p0p
